1100110010100001010011101010000001101011
01x1110110111101011100101011111100001010
0100110100100111010101101000100111111011
1101010010100001010011101010000001101011
1001010110111101011100101011111100001010
1001010100100111010101101000100111111011
1011010110111001010101000111111000001010
1010010100101101010101101100001011111010
1011110100100101010110101001101010001011
1010010101110000110010101111001000000001
1011110101011110100010101000011111111101
1000010101010010111010101111000000000110
1111110101011110101010101001111111111011
1000010101010010101010101110000010001001
1111110101011110101010101011111110011101
1000010101010000101010101001000010110101
1100110101010111101010100001011110100101
0110100101010100100010111101001010110101
1100110101010110110110100101101010010101
1000100101010100010100111000101011100101
1110110101110110110101101000101010101101
0100011101000100100101001000101010101001
1111100101111111001101101111101010101101
1000100101000001011001001000101010100110
1110111001011101010111111011111010110011
1010101101110101110100001010001011011010
1010101000100101010110111011111010001011
1000101011111101010011001010001011101001
1011101010000101011010011010111100101011
1010101010111101101011101011000101101010
1010101010100101001010101010011101001011
1010101010111101111010101010110101101010
1110101010100101001010101010010101001011
1010101010111101101010101011010101110010
1010110010100101001010101001010101011111
1010011100110101101100111101100101010001
1011100110000100100100100100111101011101
1010111011111111110101111111000111010101
1010101000000000010101000001111001010101
1010101111111111110101111110001111010101