1101010010100001010011101010000001101011
1101010110111101011100101011111100001010
1001010100100111010101101000100111111011
1101010010100001010011101010000001101011
1001010110111101011100101011111100001010
10010101001001110